8
+--+--+--+--+--+--+--+--+
   |                    |
+  +  +  +--+  +--+  +--+
|     |     |     |  |  |
+--+--+  +--+  +  +--+  +
|     |     |  |        |
+--+  +  +  +--+  +  +  +
|  |     |     |  |  |  |
+  +  +--+--+--+--+  +  +
|        |  |     |  |  |
+--+--+  +  +--+  +  +  +
|              |  |  |  |
+--+  +--+--+--+  +--+--+
|        |              |
+  +--+  +--+  +  +  +--+
|  |           |  |      
+--+--+--+--+--+--+--+--+
