8
+--+--+--+--+--+--+--+--+
   |  |  |              |
+  +  +  +--+  +--+  +--+
|                 |     |
+  +  +  +--+--+--+--+  +
|  |  |        |     |  |
+--+--+  +--+--+--+  +  +
|     |        |  |     |
+--+  +--+  +--+  +--+  +
|        |  |  |  |     |
+  +  +--+  +  +  +  +--+
|  |  |           |     |
+  +  +--+--+--+  +--+--+
|  |              |     |
+--+--+--+  +  +  +  +--+
|           |  |         
+--+--+--+--+--+--+--+--+
